# netsh wlan show profile name="HBTL5 2"

# Das Profil "HBTL5 2" auf Schnittstelle Wi-Fi:

Angewendet: Profil für alle Benutzer

## Profilinformationen

    Version                : 1
    Typ                    : Drahtlos-LAN
    Name                   : HBTL5 2
    Steuerungsoptionen     :
        Verbindungsmodus   : Manuell verbinden
        Netzwerkübertragung  : Verbinden, nur wenn dieses Netzwerk überträgt
        Automatisch wechseln         : Nicht zu anderen Netzwerken wechseln.
        MAC-Randomisierung  : Deaktiviert

## Konnektivitätseinstellungen

    Anzahl von SSIDs        : 1
    SSID-Name              : "HBTL5"
    Netzwerktyp            : Infrastruktur
    Funktyp                : [ Beliebiger Funktyp ]
    Herstellererweiterung          : Nicht vorhanden

## Sicherheitseinstellungen

    Authentifizierung         : Offen
    Verschlüsselung                 : Keine
    Sicherheitsschlüssel   : Nicht vorhanden
    Schlüsselindex              : 1

## Kosteneinstellungen

    Kosten                   : Uneingeschränkt
    Überlastet              : Nein
    Datenlimit bald erreicht: Nein
    Über Datenlimit        : Nein
    Roaming                : Nein
    Kostenquelle            : Standard
